transaction=com.itany.netClass.transaction.impl.MyBatisTransactionManager
userDao=com.itany.netClass.dao.UserDao
userServiceTarget=com.itany.netClass.service.impl.UserServiceImpl
userService=com.itany.netClass.service.proxy.UserServiceProxy
courseSetDao=com.itany.netClass.dao.CourseSetDao
courseSetServiceTarget=com.itany.netClass.service.impl.CourseSetServiceImpl
courseSetService=com.itany.netClass.service.proxy.CourseSetServiceProxy
ChapterDao=com.itany.netClass.dao.ChapterDao
ChapterServiceTarget=com.itany.netClass.service.impl.ChapterServiceImpl
ChapterService=com.itany.netClass.service.proxy.ChapterServiceProxy
resourceDao=com.itany.netClass.dao.ResourceDao
resourceServiceTarget=com.itany.netClass.service.impl.ResourceServiceImpl
resourceService=com.itany.netClass.service.proxy.ResourceServiceProxy
commentDao=com.itany.netClass.dao.CommentDao
commentServiceTarget=com.itany.netClass.service.impl.CommentServiceImpl
commentService=com.itany.netClass.service.proxy.CommentServiceProxy
courseTypeSetDao=com.itany.netClass.dao.CourseTypeSetDao
courseTypeSetServiceTarget=com.itany.netClass.service.impl.CourseTypeSetServiceImpl
courseTypeSetService=com.itany.netClass.service.proxy.CourseTypeSetServiceProxy
commentSetDao=com.itany.netClass.dao.CommentSetDao
commentSetServiceTarget=com.itany.netClass.service.impl.CommentSetServiceImpl
commentSetService=com.itany.netClass.service.proxy.CommentSetServiceProxy
userFontDao=com.itany.netClass.dao.UserFontDao
userFontServiceTarget=com.itany.netClass.service.impl.UserFontServiceImpl
userFontService=com.itany.netClass.service.proxy.UserFontServiceProxy
chapterListDao=com.itany.netClass.dao.ChapterListDao
chapterListServiceTarget=com.itany.netClass.service.impl.ChapterListServiceImpl
chapterListService=com.itany.netClass.service.proxy.ChapterListServiceProxy
recordDao=com.itany.netClass.dao.RecordDao
recordServiceTarget=com.itany.netClass.service.impl.RecordServiceImpl
recordService=com.itany.netClass.service.proxy.RecordServiceProxy
mycourseDao=com.itany.netClass.dao.MycourseDao
mycourseServiceTarget=com.itany.netClass.service.impl.MycourseServiceImpl
mycourseService=com.itany.netClass.service.proxy.MycourseServiceProxy
praiseDao=com.itany.netClass.dao.PraiseDao
praiseServiceTarget=com.itany.netClass.service.impl.PraiseServiceImpl
praiseService=com.itany.netClass.service.proxy.PraiseServiceProxy
selectFontDao=com.itany.netClass.dao.SelectFontDao
selectFontServiceTarget=com.itany.netClass.service.impl.SelectFontServiceImpl
selectFontService=com.itany.netClass.service.proxy.SelectFontServiceProxy
